111111111111111111111111111111111111111
10000000000P000000000000C00000000000001
100000000000000000000000C00000000000001
100000000000000000000000C00000000000001
100000000000000000000000C00000000000001
100000000000000000000000C00000000000001
100000000000000000000000C000000000000E1
111111111111111111111111111111111111111