11111111111
11000000001
11E00C00P01
11111111111
